
SO ./path_to_the_south_texture
S ./path_to_the_sprite_texture
NO ./path_to_the_north_texture

C 225,30,0
F 220,100,0

EA ./path_to_the_east_texture

R 1920 1080
WE ./path_to_the_west_texture


        1111111111111111101111111
        1000000000000000000000001
        10000000000000000000000011111
        1001000000000000000000001
111111111011000001110000000000001
100000000011000001110111111111101
11110111111111011100000010001  1
11110111111101011101010010001
110000001101110111000000100001
10002000000000001100000010001
10000000000000001101010010001
1000000010000000100000000000111
11110111 1110101 101111010001
11111101 1111101 111111111111
