
SO ./path_to_the_south_texture
S ./path_to_the_sprite_texture
NO ./path_to_the_north_texture

C 225,30,0
F 220,100,0

EA ./path_to_the_east_texture

R 800 600

WE ./path_to_the_west_texture

    11111111111111111
    10000000000000001
    10000111111100001
111110011      100001
1000001    1111100011
100000111110000000001
10000000100002000N011
100020000100000000001
111100001111111111111
    1111
