S  ./textures/mexicain.xpm
NO ./textures/fff.xpm
WE	 ./textures/barca.xpm
EA     ./textures/world_cup.xpm
SO  ./textures/ldc.xpm
C  256 ,   180,,  180
F 100 ,210,195



R 1200 900

    11111111111        11111111
    10020000201        10000001
   1100000000011      1100000011
   1000000000001      1000020001
   10000000000011111111000000001
11112000000000020001011000020001
1000000000000001000000200000000111111
1000200000002000000000100000000002001
1000000001111111111000000001110000001
1000000001        1000000201 10000001
1000000011        1100000011 11000011
110000001          10020001   100001
 10000001          10000111   100001
 10000001111111111110000111111100201
 10000000000000200000000000000000001
 1002N000000000000000020000002000001
 11111100211111111110000111101111021
 11111111111111111111111111111111111

