
S ./path_to_the_sprite_texture
NO ./path_to_the_north_texture

C 225,30,0
SO	 ./path_to_the_south_texture
F 220,100,0

EA ./path_to_the_east_texture
WE ./path_to_the_west_texture

R 800 600


    11111111111111111
    10000000000000001
    10000000000000001
111110000000000000001
100000000000000000011
100000111110000000001
10000000100000000W011
100020000100000000001
111100001111111111111
    1111
