
S  ./textures/mexicain.xpm
NO ./textures/gryffindor.xpm
WE	 ./textures/hufflepuff.xpm
EA     ./textures/slytherin.xpm
SO  ./textures/ravenclaw.xpm

C  100 ,   100,,  100
F 215 ,210,195


R 1000 800 


    11111111111111111
    12000000000000201
    10000002000000001
111110000000000000001
100000000200000000011
10000011111000000W001
100000002000000000011
100000000100200002001
111100001111111111111
    1111

