
S  ./textures/mexicain.xpm
NO ./textures/wood2.xpm
WE	 ./textures/red.xpm
EA     ./textures/diamond.xpm
SO  ./textures/wood3.xpm

C  255 ,   100,,  100
F 215 ,210,195


R 1000 800 


    11111111111111111
    12222222222222201
    12222222222222221
111112222222222222221
122222222222222222211
12222211111000000W221
122222222222222222211
122222222122222222221
11112221111111111111
    1211
111112211111111111111
122222222222222222221
111111111111111111111
