
S  ./textures/mexicain.xpm
NO ./textures/wood2.xpm
WE	 ./textures/red.xpm
EA     ./textures/diamond.xpm
SO  ./textures/wood3.xpm

C  255 ,   100,,  100
F 215 ,210,195


R 1000 800 


    11111111111111111
    10000000002000001
    12000000000000021
111110020000000000001
100000000200000200011
100000111110000000001
100002000000N00200011
10000000010000000001
11110001111111111111
    1011
111110011111111111111
100000000000000000001
111111111111111111111
