
S  ./textures/arbitre.xpm
NO ./textures/fff.xpm
WE	 ./textures/world_cup.xpm
EA     ./textures/barca.xpm
SO  ./textures/ldc.xpm

C  100 ,   100,,  100
F 100 ,210,100


R 1000 800 

1111111111111111111111111111111
1002000000000000000000200000001
10000E0000000000000000000000001
1000000000001111100000000000021
11111000200001  100000200000001
    1000000001  100000000000001
1111100000000111100000000000001
1000000000000000000000011100001
100000002000000000000021 100001
111111111111111111111111 111111
