
S  ./textures/mexicain.xpm
NO ./textures/wood2.xpm
WE	 ./textures/red.xpm
EA     ./textures/eagle.xpm
SO  ./textures/wood3.xpm

C  255 ,   100,,  180
F 18 ,210,195


R 1000 800 

1111111111111111111111111111111
1002000000000000000000200000001
1000000000000000000000000000001
1000000000001111100000000000021
11111000200001  10000020000W001
    1000000001  100000000000001
1111100000000111100000000000001
1000000000000000000000011100001
100000002000000000000021 100001
111111111111111111111111 111111
