S ./textures/mexicain.xpm
    	R 1280 950
	NO       ./textures/barca.xpm
		SO ./textures/world_cup.xpm
		WE ./textures/fff.xpm

EA    ./textures/ldc.xpm

F    243,233,177
	C 124,199,160


                  1111111111111
                111100000000000111
              1100002000200020000011
            1100000000000000000000011
           111111111111102000000000011
          110000000000000000000000000011
         11000000000000111111111111111111
        1100000000000200000000000000020011
       110200000000000000000000000000000011
      11000000000000001101100000000000000011
     1100000011111111102020111111110000200011
    110000000000000100000000010000000000100011
   11000120000000010000000000010000000001000011
   10000110000000120000000000021000000011000001
   100000100000000000000N0000000000000010000001
   10000010000000120000000000021000000010000001
   11000110000000010000000000010000000011000011
    110012000000000100000000010000000000100011
     1100000011111111102020111111110000200011
      11000000000000001101100000000000000011
       110000200000000000000000000200000011
        1100000000000000000000000000000011
         11000000000000000000000000000011
          110000000000002000000000000011
           1111111111111110000000000011
            11000000000000000000200011
             110000002000111111111111
              1100000000000000000011
                1110000000002000111
                 1102000000000011
                   111111111111

