S ./textures/mexicain.xpm
    R 1280 950
    NO      ./textures/barca.xpm
        SO ./textures/world_cup.xpm
	WE ./textures/fff.xpm

EA    ./textures/ldc.xpm

    F    243,233,177
C 124,199,160


11111111111111111111111111111111111111111111111111
10000000000000000000111111111100000000000000000001
10000000001000000000000020000000000000010000000001
10000000001000000000000000000000000000010000000001
10000000001000002000000000000000200000010000000001
10002000001000000000000000000000000000010002000001
10000000001111111111110000001111111111110000000001
10000000000000000000010000001000000000000000000001
10000000000000000000001120110000000000000000000001
10000000020000000000000000000000000000020000000001
10000000000000000000000000000000000000000000000001
10000000000000000000011111111000000000000000000001
10000000000200000000000000000000000000200000000001
10000000000000000001000020000010000000000000000001
111100111111111111110E0000000011111111111111001111
10000000000000000001000000000010000000000000000001
10000000000000000000000000000000000000000000000001
10000000000000000000011111111000000000000000000001
10000000000000000000000000000000000000000000000001
10000000000000000000000000000000000000000000000001
10000000000000000000001101110000000000000000000001
10000000000000000000010000001000000000000000000001
10000000001111111111110000001111111111110000000001
10000000001000000000000000000000000000010000000001
10000000001000000000000000000000000000010000000001
10000000001000000000000000000000000000010000000001
10000000001000000000000000000000000000010000000001
10000000000000000000111111111100000000000000000001
11111111111111111111111111111111111111111111111111
