S ./textures/mexicain.xpm
                R 1280 950
     NO       ./textures/barca.xpm
           SO ./textures/world_cup.xpm
WE ./textures/fff.xpm
EA    ./textures/ldc.xpm


F    243,233,177
   C 124,199,160

111111111     111111111                    1111111 1111111                  
100002001      100000001                    1000001 1000001                 
 100000001     100200001                    1000201 1002001
 110000001     100000011                    1000001 1000001                 
  10020001     1000001      1111111111111    100001  100001    111111111111  
   10000001     1000001    1100000000000011   100001  100001  110000000000011 
    1000000111110000021   10000001111100000111100001  102001 10020000002000001
    1000000000000E000001  10002001    10000000000001  100001 10000011111000001
    1000000002000000001  100000001111100020011100001  100001 100001     100001
    1000000111110000001  1000000000000000001  100001  100001 100001     100001
    1020001     1000001  100000011111111111   100001  100001 100001     100001
    1000001     1000001111100000001           100001  100001 100001     100001
  110000001     1000000000000020001          100000011000000110000011111000001
  100000001     100020001110000000011111111  100020000000020000000000020000001
  100000001     100000001  1100000000002001  10000001100000011110000000000011 
  111011111     111111111    11111111111111  1111111111111111   11111111111   
    101
    1011111      1111111    111111111111111111 
   10000201     10000001    100000000002000001 
  100000001    100020001    100000000000000001 
  111000001    111000001    100000111111111111 
     102001       100001    1000001            
     100001       100001    1000001            
     100001       100201    1002001111111111   
     100001       100001    10000000000000001  
     100001       100001    111111111111000001 
     100001       100001                1000001
     100001       100001                1000001
     100001       100001   11111111     1000001
  111000000111 11100000011100000000111110002001
  10000200000010000020000000111000000000000011 
  10000000000000000000000011   1100000000011   
  1111111111111111111111111      111111111
